##############################
#............................#
#....#############.###.#g#.#.#
#....#.............#.#.#...#.#
#....#.#############.#.#####.#
#f####.#e#.#.#.#.#.#.#.....#.#
#....#.#...........#.#####.#.#
#.####.###########.#.#c#d#.#.#
#.#................#.......#.#
#.####.#####################.#
#.........................a#b#
##############################
