#########
####u####
####.####
####.####
#l....r.#
####b####
####.####
####.####
#########
